1111111111
1P0C000CE1
1000C00001
1C00000C01
1111111111