1111111111
1P000C0CE1
1000C00001
1111111111