1111111111111111111111
1000000000000000000001
1000P00000C00C0000C001
1000000111110000000001
1000000000000000000001
1000C00000000C00000001
1000000000000000000001
1000000111110000000001
1000C00000000000C00001
1000000000000000000001
10000000000E0000000001
1111111111111111111111