111111111111111
1P00000C000C001
100111111111001
1C0100000001001
1001000C0001001
100100000001CE1
1000000000000C1
111111111111111