11111111111111111111
1P000C00000000000001
1011111111111111C001
10000000C00000000101
1C111111111111101101
100000000000C0001001
10111111111111111001
1C00C000000000000001
10000000C000000000E1
11111111111111111111