111111111111111
1P00000C000C001
100111111110101
1C01000000010C1
1001011110010C1
10010C0000010E1
1001111111111C1
111111111111111